#################
#S..#####.#..####
#.#.....#.##.#..#
#..##.#...#....##
##...####...#####
#...#.....###..##
###.####.##...###
#...###....######
#.#...##.#.##..##
#.##.#...#...####
####..####.######
####.##.#..##..##
##...#..#.##..###
#..##..#.....####
######.##.##.####
##....###..#....#
###############X#